6
37
0 0 0 0 0 0 0 0 0 0 0 0 0 0 8 0 0 0 0 0 0 0 7 5 5 5 0 0 0 0 0 0 0 0 0 0 0
0 1 0 0 0 7 0 0 0 0 0 0 0 0 0 0 0 0 0 0 0 0 0 0 0 0 0 0 5 0 0 0 0 0 0 6 0
0 0 0 0 0 0 0 0 5 0 0 0 0 5 5 5 0 0 0 0 5 4 0 0 5 0 0 0 5 0 0 0 0 0 0 5 0
0 0 0 0 0 5 0 0 0 0 0 0 0 0 0 0 0 0 0 0 5 5 5 0 0 0 5 0 5 0 0 5 0 0 0 5 0
0 0 0 0 0 0 0 0 5 0 0 0 0 0 0 0 0 0 0 0 0 0 0 0 0 0 0 0 5 0 0 0 0 0 5 5 0
5 5 5 5 5 5 5 5 5 5 0 4 7 4 0 4 5 5 5 0 7 0 0 7 4 9 9 5 5 4 0 0 0 5 5 5 5