6
37
1 5 5 5 5 5 5 5 5 5 5 5 5 5 5 5 5 5 5 5 5 5 5 5 5 5 5 5 5 5 5 5 5 5 5 5 5
0 5 0 7 0 5 5 5 5 5 7 0 0 0 0 0 0 0 5 5 5 5 5 5 5 5 5 5 0 7 0 0 0 0 0 5 5
0 5 5 7 5 5 5 5 5 5 0 5 5 5 5 5 5 0 0 5 5 5 5 5 5 5 5 5 5 0 5 5 5 0 0 0 5
0 0 0 0 0 5 5 0 0 0 0 5 5 5 5 5 5 5 0 0 0 0 0 0 0 0 5 0 0 0 0 0 5 0 5 4 5
5 5 0 5 0 4 0 0 5 5 5 5 5 5 5 5 5 5 0 5 5 5 5 0 4 0 0 0 5 5 5 0 0 0 5 5 5
5 5 0 5 5 5 5 5 5 5 5 5 5 5 5 5 5 5 9 5 5 5 5 9 5 5 5 5 5 5 5 4 0 0 0 0 6
