6
37
1 0 0 0 0 0 0 0 0 5 5 5 0 0 0 0 0 0 0 0 0 8 0 0 0 0 0 0 0 0 0 0 7 0 0 0 0
0 0 0 0 0 0 0 0 0 5 7 5 0 0 0 0 0 0 0 0 5 5 0 0 0 0 0 0 0 0 0 0 0 0 0 0 6
5 5 0 5 0 0 0 0 0 0 0 0 0 0 0 0 0 0 0 0 0 0 0 0 0 0 0 0 0 0 0 0 0 0 0 0 5
5 5 0 5 0 0 0 0 0 5 5 5 5 0 0 0 0 0 5 5 0 0 5 5 0 0 5 5 0 5 5 0 0 5 0 0 5
5 5 0 5 0 4 0 5 0 0 0 0 0 0 0 0 0 5 5 5 4 7 5 5 0 0 0 0 0 0 0 0 0 0 0 0 5
5 5 9 5 5 5 5 5 4 0 0 0 4 0 0 4 5 5 5 5 5 5 5 5 0 0 4 0 0 7 0 0 4 0 4 5 5
