6
37
1 7 0 0 0 0 0 7 0 7 0 0 0 0 0 0 0 0 0 0 0 0 0 0 0 0 0 0 0 0 0 0 0 0 0 0 0
0 0 0 0 0 0 0 0 0 0 0 0 0 0 0 0 0 0 0 0 0 0 0 0 0 0 0 0 0 0 0 0 0 0 0 0 6
5 0 5 0 5 0 5 0 5 0 5 0 0 0 0 0 0 5 0 7 0 0 0 0 0 0 0 0 5 5 0 0 0 0 0 0 5
0 0 0 0 0 0 0 0 0 0 0 0 0 0 0 0 0 5 0 0 7 0 0 0 0 0 0 0 5 0 0 5 0 0 0 4 5
0 0 0 0 0 0 0 0 0 0 0 0 0 0 0 0 5 5 0 0 0 7 0 0 0 0 0 0 0 0 5 5 5 5 5 5 5
0 9 0 9 0 9 0 9 0 9 0 0 4 4 4 5 5 5 9 9 9 9 8 0 4 4 0 0 5 5 5 5 5 5 5 5 5
